Dún - Sound
Dùn - Sweet

Mí- Breathe 
Mì- Shake

Ọba- King
Ọbà- Name of Sango's wife

Oko - Farm 
Òkò- Town
Okó- Pennis 

Àgbẹ̀ - Farmer 
Agbẹ́- Name of person 

Agbè - Gourd
Agbe - Begging 
Àgbé- (Name of lineage) 

Ọ̀bọ̀- Name of tree
Ọ̀bọ- Monkey 

Abọ́- Plate 
Abọ̀- Welcome 

Sùn - Sleep 
Sún - Move 
Sun-(Something increase)

Ẹ̀rọ- Machine 
Ẹ̀rọ̀- Ease 

Ṣòkòtò - Trousers 
Sókótó - Name of a town 

Ẹbí - Family 
Ẹ̀bi- Fault 

Ìbí- Lineage 
Ibí - Here
Ibi - Placenta 
Ibi - Bad

Ẹ̀já - Doubt 
Ẹja - Fish 

Àṣà- Culture 
Àṣá- Lark 
Aṣà- Name of a place 

Irun - Hair 
Ìrun - (Prayer done by Muslim) 

Òdí - Ifá corpus 
Odi - Dumb 
Òdí - Arẹ̀ṣà lineage 

Ọpẹ́ - Thank 
Ọ̀pẹ́- Palm tree 
Ọ̀pẹ́- Unmoving object 


Agbọ́n - Wasp 
Àgbọn - Coconut 
Àgbọ̀n - Chin 
Agbọ̀n- Basket 

Ọgbọ́n - Wisdom 
Ọgbọ́n - Thirty 

Irú - Locust beans 
Ìrù- Tail 

Eré - Play
Èrè - Gain 
Ère - Statue 

Òjó - Name of a person 
Òjó - Rain 
Ojo - Coward 

Èsì - Response 
Èsì - Wild pig 

Olú- Mushroom 
Olú- Name of a person 
Òlù - Instrument used to pressed clothes in olden days

Olùkọ́ - Teacher 
Olùkọ - (Someone who writes) 
Olùkọ̀ - Activist 

Òye - Insight 
Oyè - Title 

Ẹ̀jẹ̀ - Blood 
Ẹ̀jẹ́- Promise 

Jẹ - Eat 
Jẹ́ -(Become something) 

Ẹṣin - Horse 
Ẹ̀sín - Embarrassment
Ẹ̀ṣìn - Religion 

Àtọ̀ - Sperm
Atọ́ - Mini calabash 

Ẹ̀ṣẹ̀ - Sin 
Ẹsẹ̀- Leg 

Ìgbín - Snail 
Igbìn - Obatala's drum 

Mu- Drink 
Mú -Pick 

Yé - Understand 
Yè - Survive 

Há - Distribute
Ha - Peel 

Rán - Send errand 
Ràn - Help 
Rán - Sew 

Dù - (To contest for position) 
Dú - Slaughter 

Rẹ̀ - Tire 
Rẹ - (To dye something) 
Rẹ́ - Cut

Ikùn - Squirrel 
Ikùn - Belly 
Ikun - Mucus 

Bọ̀ - Arrive 
Bọ́ - Feed 
Bọ̀ - Worship 

Irin - Iron 
Ìrìn - Walking 

Ìyá - Mother 
Ìyà - Beating 
Ìyá - ( Name of leave ) 

Ẹ̀rù - Fear 
Ẹrú - Slave 
Ẹrù - Luggage 

Ẹ̀dà - (Duplicate of something) 
Ẹ̀dá - Human being 
Ẹ̀dà - The name of disease 

Àgbà - Elder 
Àgbá - Drum 
Agba - Rope 

Àná - Yesterday 
Àna - In law 

Apó - Hunter's bag
Àpò - Pocket 

Ìró - News 
Ìró - Sound 
Ìrò - Wrapper 

Igba - Two hundred 
Ìgbà - Time 
Ìgbá - Locust beans 

Pé - Complete 
Pé - (To come together) 
Pè - Call 

Àtẹ - Collection of something 
Àtẹ́ - Food without salt 

Àbá - Suggestion 
Àbá (The name of an area in IBADAN)
Abá - Village 

Gùn - Tall
Gùn - (To climb something) 
Gún - Grind /Pound 

Bẹ̀ - Beg 
Bẹ - (To peel something) 

Àkókò - Time 
Àkókó - The name of town in Ondo 

Ọ̀bẹ - Knife 
Ọbẹ̀ - Soup 

Ìlú - Town 
Ìlù - Drum 


Kọ - Write
Kọ́ - Learn 
Kọ̀ - Against 

Mọ̀ - Know 
Mọ́ - Clean 
Mọ - Build 

Pọ́n - Ripe 
Pọ̀n - Back 
Pọn - Fetch 

Ìbà - Praise 
Ìbà - The title of Kish's king 
Ibà - Malaria 
Ibà - The name of town in Osun state 

Kẹ̀kẹ́ - Bicycle 
Kẹ́kẹ́ - A kind of tribal mark 

Àrẹ̀mọ̀ - Heir 
Arẹmọ - The name of a place in Ibadan 

Ẹmu - Palmwine 
Ẹmu - Plyer 
Ẹ̀mù - (The part in yam that is not suitable for eating) 

Àrán - (Velvet:Name of a cloth) 
Àrán - Name of a town in Kwara State 
Aràn - Earthworm 

Títì - Road 
Títí - Name of a person 


Àrà -  Wonder 
Àrá - Thunder 
Ara - Body 

Èjí - Gap-tooth
Eji - Rain 
Èjì - Two 

Yọ̀ - Delight 
Yọ́ - Dissolve 
Yọ - Remove 

Ẹ̀ta - Triplet
Ẹtà - Bush dog 
Ẹ̀ta - Three 

Lé - Pursue 
Le - Hard

Ìwó - A town in Osun state 
Ìwo - Horn

Tán - Finish 
Tàn - Deceive 
Tan - Relate 

Ọgbẹ̀ - An area in Oyo 
Ọgbẹ́ - Injury 

Dà - Betray 
Dá - Create 
Dà - (To pour something) 

Olúwa - God
Olùwà - The subject of the sentence 
Olùwá - The searcher /Finder 

Ọ̀sẹ̀ - Week 
Ọṣẹ - Soap 

Ìwé - Book
Iwe - Gizzard 

Òdòdó - Flower
Òdodo - Truth 

Ẹ̀kọ́ - Education 
Ẹ̀kọ - Pap

Ọkọ - Husband 
Ọkọ̀ - Motor 
Ọkọ́ - Hoe 

Orúkọ - Name 
Òrúkọ - (Buck - Male goat) 

Bàtà - Footwear 
Bàtá - Sango drum 

Ẹ̀gbá - The name of a town 
Ẹgba - Cane 
Ẹ̀gbà - Jewelry 

Ifá - Oracle 
Ìfà - Inordinate gain 

Ẹyẹ - Bird 
Ẹ̀yẹ - Celebration 

Ọ̀rẹ́ - Friend 
Ọrẹ - Charity 
Ọ̀rẹ̀ - Name of a town in Ondo State 

Ìtẹ́ - Throne 
Itẹ́ - Cementry 

Ètè - Lips 
Ète - Pretence 

Ọ̀tun - New 
Ọ̀tún - Right side 

Olórí - Leader
Olorì - Queen 
Olórì - The name of a village in Oyo town 

Àga - Chair 
Agà - Ladder 

Ẹ̀gbẹ́ - Group 
Ẹ̀gbẹ́ - Side 
Ẹ̀gbẹ - Name of disease (Prolonged gonorrhoeal) 

Agbada - Frying pot 
Agbádá - Flowing wide-sleeved robe

Ẹkún - Crying 
Ẹkùn - Regional 
Ẹkùn - Leopard 
Ẹ̀kún - Complete 

Iná - Fire 
Ìná - Cashew nut 

Ìkòkò - Pot
Ìkókó - New born 

Èdè - Language 
Edé - Crayfish 

Àwọ̀ - Colour
Awọ - Skin 

Awó - Guinea fowl 
Awo - Initiator /Herbalist 
Awo - Plate 

Orò - Ritual 
Oró - Venum 
Òro - Bushmango 
Òró - A town in Kwara State 

Ọ̀rọ̀ - Word 
Orọ̀ - Wealth 

Iyán - Pounded Yam 
Iyàn - Argument
Ìyàn - Starve 

Igbó - Bush 
Ìgbò - Name of tribe 
Ígbò - An ethnic in Nigeria 

Aṣọ - Cloth 
Aṣọ̀ - Conflict 

Ogún - Twenty 
Ogún - Inheritance 
Ògún - god of iron 
Ogun - War
Ọ̀gùn - Name of a town 

Ẹyin - Egg 
Ẹ̀yìn - Back 
Ẹ̀yin - You 
Ẹyìn - Palm fruit 

Iṣẹ́ - Work 
Ìṣẹ́ - Poverty 

Odò - River 
Odó - Mortal 

Ilà - Tribal mark 
Ìlá - Name of a town in Osun State 
Ilá - Okro 

Ìlàṣà - Another name for gun 
Ìlaṣa - Okro leave 

Ọwọ́ - Hand
Ọ̀wọ̀ - Respect 
Ọwọ̀ - Broom 

Ọ̀ṣọ́ - Adornmemt 
Ọṣọ́ - Trap for catching animal

Bàbá - Father
Bàbà - Millet

Òwú - The name of a town
Owú - Jealousy
Òwú - Silk

Ọmọ - Child 
Ọ̀mọ̀ - Name of a tree 

Òòrùn - Sun 
Òórùn - Smell 
Oorun - Sleep 

Ikọ́ - Cough 
Ikọ̀ - Organization 

Ẹdẹ - Town 
Ẹ̀dẹ̀ - Passage 
Ẹ̀dẹ - Deceitful 

Ajá - Dog 
Àjà - Roof 


Ọyàn- Breast
Ọ̀yán - Town


Arọ - Disabled person 
Àrọ̀ - Catfish

Wèrè - Madness
Wéré - Hurry

Oṣù - Month 
Òsú - Name of a town

Kí - Greet 
Kì - Praise 

Òjìjí - Shadow 
Òjijì - Suddenly 

Sọnù - Lost 
Sọnú - To remember something 

Ṣakí - Name of a town
Sàkì - Beef tripe 

Kú - Die 
Kù - Remain 

Lá - Lick 
Là - Open

Yá - Borrow 
Yà - Draw, take picture

Ìsìn - Church service 
Ìsín - small fish

Wò - Look 
Wó - Collapse 

Kùn - Murmur
Kún - Sufficient 

Dà - To pour something 
Dá - To pieces something 

Sọ - Talk 
Sọ́ - Guard 

Tẹ̀ - Press 
Tẹ́ - Embarrass

Nà - Beat 
Ná - Spend 


Àrún - Five
Àrùn - Disease 

Ògidì - Origina 
Ogidi - The name of an area in Ilorin 

Ọ̀rá - Nylon 
Ọ̀rà - Name of a town 

Mímọ́ - Holy 
Mímọ̀ - Knowledge 

Ọ̀tá - Enemy 
Ọ̀ta- Bullet 

Àgbàrá - Erosion 
Agbára - Power 

Òkúta - Stone 
Òkùtà - Lack of sales 

Irọ́ - Lying 
Irọ̀ - Mate

Ọpọlọ - Brain 
Ọ̀pọ̀lọ́ - Frog

Òkun - Sea 
Okun - Energy 
Okùn - Rope 

Ọ̀run - Heaven
Ọrùn - Neck 
